dostęp do Internetu : der Internetzugang
ponowne zjednoczenie : die Wiedervereinigung
przemysł : die Industrie
przestrzeń, trasa : die Strecke
nacisnąć klawisz / przycisk : auf eine Taste drücken
pendrive : der Stick
adres e-mailowy : die E-Mail-Adresse
zepsuty : kaputt
klikać : klicken
kursować : pendeln
środek transportu : das Verkehrsmittel
zamek : das Schloss
postój : der Zwischenstopp
wylogować się : sich ausloggen
zainstalować : installieren
dysk twardy : die Festplatte
wyłączony : ausgeschaltet
pchli targ : der Flohmarkt
zeskanować : einscannen
nieograniczony : unbegrenzt
akumulator, ładowarka (nazwa skrócona) : der Akku
włączony : eingeschaltet
klasztor : das Kloster
klawiatura : die Tastatur
okolica : die Umgebung
podać hasło : das Passwort eingeben
nacisnąć guzik : einen Knopf drücken
ściągnąć (z internetu) : herunterladen
pustynia : die Wüste
bydło : das Vieh
obsługa komputera : die Computerbedienung
powrót : die Rückfahrt
szukać w internecie : im Internet recherchieren
kierunek : die Richtung
przyzwyczajać : gewöhnen
faks : das Faxgerät
łącze internetowe : der Internetanschluss
zapisywać (dane) : speichern
zator, korek : der Stau
pośpiech : die Hektik
teren, obszar, terytorium, obręb : das Gebiet
strona internetowa : die Webseite
izba niższa niemieckiego parlamentu : der Bundestag
informować o : informieren über
ekran : der Bildschirm
zainstalować program : ein Programm installieren
przemierzać : durchqueren
było super! : es war Spitze
lampa naftowa : die Petroleumlampe
dzień powszedni z wykorzystaniem mediów : der Medienalltag
na bieżąco : auf dem Laufenden
mól książkowy : die Leseratte
program sportowy : die Sportsendung
sznur, sznurek, przewód, kabel : die Schnur
ulubiona muzyka / gatunek muzyczny : die Lieblingsmusik
dług : die Schuld
pilna potrzeba, nagła potrzeba : der Notfall
ubezpieczenie : die Versicherung
magia : die Magie
masa ludzi : die Menschenmasse
niebezpieczeństwo, ryzyko : die Gefahr
dzieło sztuki : das Kunstwerk
umowa na telefon komórkowy : der Handyvertrag
cyfryzacja : die Digitalisierung
lokomotywa : die Dampflok
druk w książce : der Buchdruck
zależny od : abhängig von
wynalazca : der Erfinder
rzecz : das Ding
straż pożarna : die Feuerwehr
powóz, dorożka : die Kutsche
wieloraki, wielorako : vielfältig
o niskich kosztach, przy niskich kosztach : kostengünstig
wystarczający : ausreichend
łatwo dostępny : zugänglich
zafascynowany sportem : sportbegeistert
odtwarzać, grać : abspielen
zajmować się czymś : sich befassen mit
wizualizować : visualisieren
